decile_rank,min_score,max_score,count,Total_OutstandingBalance,cum_Outstandingbalance,cum_total,Cum_Perc_Customers,Perc_Cum_OutstandingBal 
1,386,388,11635,15309881959,15309881959,11635,17%,18%
2,376,386,11634,12069043302,27378925261,23269,33%,31%
3,330,376,11634,15240734057,42619659318,34903,50%,49%
4,311,330,11634,16269389277,58889048595,46537,67%,68%
5,304,311,11634,14669943237,73558991832,58171,83%,84%
6,300,304,11634,13571007421,87129999253,69805,100%,100%
